104 104 104 104 104 104 104 104 104 104 104 104 104 104 104 104 104 104 104 104 104 104 104 104 104 104 104 104 104 104 104 104 104 104 104 104 104 104 104 104 104 104 104 104 104 104 104 104 104 104 104 104 104 104 104 104 104 104 104 104 104 104
104 104 104 104 104 104 104 104 104 104 104 104 104 104 104 104 104 104 104 104 104 104 104 104 104 104 104 104 104 104 104 104 104 104 104 104 104 104 104 104 104 104 104 104 104 104 104 104 104 104 104 104 104 104 104 104 104 104 104 104 104 104
104 104 104 104 104 104 104 104 104 104 104 104 104 104 104 104 104 104 104 104 104 104 104 104 104 104 104 104 104 104 104 104 104 104 104 104 104 104 104 104 104 104 104 104 104 104 104 104 104 104 104 104 104 104 104 104 104 104 104 104 104 104
104 104 104 104 104 104 104 104 104 104 104 104 104 104 104 104 104 104 104 104 104 104 104 104 104 104 104 104 104 104 104 104 104 104 104 104 104 104 104 104 104 104 104 104 104 104 104 104 104 104 104 104 104 104 104 104 104 104 104 104 104 104
104 104 104 104 104 104 104 104 104 104 104 104 104 104 104 104 104 104 104 104 104 104 104 104 104 104 104 104 104 104 104 104 104 104 104 104 104 104 104 104 104 104 104 104 104 104 104 104 104 104 104 104 104 104 104 104 104 104 104 104 104 104
104 104 104 104 104 104 104 104 104 104 104 104 104 104 104 104 104 104 104 104 104 104 104 104 104 104 104 104 104 104 104 104 104 104 104 104 104 104 104 104 104 104 104 104 104 104 104 104 104 104 104 104 104 104 104 104 104 104 104 104 104 104
104 104 104 104 104 104 104 104 104 104 104 104 104 104 104 104 104 104 104 104 104 104 104 104 104 104 104 104 104 104 104 104 104 104 104 104 104 104 104 104 104 104 104 104 104 104 104 104 104 104 104 104 104 104 104 104 104 104 104 104 104 104
104 104 104 104 104 104 104 104 104 104 104 104 104 104 104 104 104 104 104 104 104 104 104 104 104 104 104 104 104 104 104 104 104 104 104 104 104 104 104 104 104 104 104 104 104 104 104 104 104 104 104 104 104 104 104 104 104 104 104 104 104 104
104 104 104 104 104 104 104 104 104 104 104 104 104 104 104 104 104 104 104 104 104 104 104 104 104 104 104 104 104 104 104 104 104 104 104 104 104 104 104 104 104 104 104 104 104 104 104 104 104 104 104 104 104 104 104 104 104 104 104 104 104 104
104 104 104 104 104 104 104 104 104 104 104 104 104 104 104 104 104 105 105 105 105 105 101 101 101 101 101 101 101 101 101 101 101 101 101 101 101 101 101 101 101 101 101 101 101 104 104 104 104 104 104 104 104 104 104 104 104 104 104 104 104 104
104 104 104 104 104 104 104 104 104 104 104 104 104 104 105 105 105 105 105 105 101 101 101 101 101 101 101 101 101 101 101 101 101 101 101 101 101 101 101 101 101 101 101 101 101 101 101 104 104 104 104 104 104 104 104 104 104 104 104 104 104 104
104 104 104 104 104 104 104 104 104 104 104 104 105 105 105 105 105 105 105 105 101 101 101 101 101 101 101 101 101 101 101 101 101 101 101 101 109 109 109 109 109 109 109 109 101 101 101 101 104 104 104 104 104 104 104 104 104 104 104 104 104 104
104 104 104 104 104 104 104 104 104 104 104 105 105 105 105 105 105 105 105 105 101 101 101 101 101 101 101 101 101 101 101 101 101 101 101 101 110 110 110 110 110 110 110 110 101 101 101 101 104 104 104 104 104 104 104 104 104 104 104 104 104 104
104 104 104 104 104 104 104 104 104 104 104 105 105 105 105 105 105 105 105 105 101 101 101 101 101 101 101 101 101 101 101 101 101 101 101 101 110 110 108 108 108 108 110 110 101 101 101 101 104 104 104 104 104 104 104 104 104 104 104 104 104 104
104 104 104 104 104 104 104 104 104 104 105 105 105 105 105 105 105 105 105 105 101 101 101 101 101 101 101 101 101 101 101 101 101 101 101 101 110 110 101 101 101 101 110 110 101 101 101 101 104 104 104 104 104 104 104 104 104 104 104 104 104 104
104 104 104 104 104 104 104 104 104 104 105 105 105 105 105 105 105 105 105 105 101 101 101 101 101 101 101 101 101 101 101 101 101 101 101 101 110 110 101 101 101 101 110 110 101 101 101 101 104 104 104 104 104 104 104 104 104 104 104 104 104 104
104 104 104 104 104 104 104 104 104 104 105 105 105 105 105 105 105 105 105 105 101 101 101 101 101 101 101 101 101 101 101 101 101 101 101 101 110 110 101 101 101 101 110 110 101 101 101 101 104 104 104 104 104 104 104 104 104 104 104 104 104 104
104 104 104 104 104 104 104 104 104 104 105 105 105 105 105 105 105 105 105 105 101 101 109 109 109 109 109 109 109 109 109 109 109 109 109 109 110 110 101 101 101 101 110 110 101 101 101 101 101 104 104 104 104 104 104 104 104 104 104 104 104 104
104 104 104 104 104 104 104 104 104 104 104 105 105 105 105 105 105 105 105 105 109 109 110 110 110 110 110 110 110 110 110 110 110 110 110 110 110 110 109 109 109 101 110 110 101 101 101 101 101 104 104 104 104 104 104 104 104 104 104 104 104 104
104 104 104 104 104 104 104 104 104 104 104 105 105 105 105 105 105 105 105 101 108 110 110 110 110 110 110 108 108 108 108 108 108 108 108 108 108 108 108 110 110 101 110 110 101 101 101 101 101 104 104 104 104 104 104 104 104 104 104 104 104 104
104 104 104 104 104 104 104 104 104 104 104 105 105 105 105 105 105 105 105 101 101 108 108 108 108 108 108 101 101 101 101 101 101 101 101 101 101 101 101 108 108 101 110 110 101 101 101 101 101 104 104 104 104 104 104 104 104 104 104 104 104 104
104 104 104 104 104 104 104 104 104 104 104 105 105 105 105 105 105 105 105 101 101 101 101 101 101 101 101 101 102 102 102 103 103 102 102 103 102 103 103 111 111 111 110 110 101 101 101 101 101 104 104 104 104 104 104 104 104 104 104 104 104 104
104 104 104 104 104 104 104 104 104 104 104 105 105 105 105 105 105 105 105 101 101 102 102 103 102 102 102 103 103 101 101 101 101 101 101 101 101 102 101 110 110 110 110 108 101 101 101 101 101 104 104 104 104 104 104 104 104 104 104 104 104 104
104 104 104 104 104 104 104 104 104 104 104 105 105 105 105 105 105 102 102 103 102 102 101 101 101 101 101 101 101 101 101 101 101 101 101 101 101 102 101 110 110 110 108 101 101 101 101 101 101 104 104 104 104 104 104 104 104 104 104 104 104 104
104 104 104 104 104 104 104 104 104 104 104 105 105 105 105 105 105 105 105 101 101 101 101 101 101 101 101 101 101 101 101 101 101 101 101 101 101 102 101 108 108 108 101 101 101 101 101 101 101 104 104 104 104 104 104 104 104 104 104 104 104 104
104 104 104 104 104 104 104 104 104 104 104 105 105 105 105 105 105 105 105 101 101 101 101 101 101 101 101 101 101 101 101 101 101 101 101 101 101 103 101 101 101 101 101 101 101 101 101 101 101 104 104 104 104 104 104 104 104 104 104 104 104 104
104 104 104 104 104 104 104 104 104 104 105 105 105 105 105 105 105 105 101 101 101 101 101 101 101 101 101 101 101 101 101 101 101 101 101 101 101 103 103 102 102 102 102 102 101 101 101 101 101 104 104 104 104 104 104 104 104 104 104 104 104 104
104 104 104 104 104 104 104 104 104 104 105 105 105 105 105 105 105 105 101 101 101 101 101 101 101 101 101 101 101 101 101 101 101 101 101 101 101 101 101 101 101 101 101 102 101 101 101 101 104 104 104 104 104 104 104 104 104 104 104 104 104 104
104 104 104 104 104 104 104 104 104 104 105 105 105 105 105 105 105 105 101 101 101 101 101 101 101 101 101 101 101 101 101 101 101 101 101 101 101 101 101 101 101 101 101 107 101 101 101 104 104 104 104 104 104 104 104 104 104 104 104 104 104 104
104 104 104 104 104 104 104 104 104 104 105 105 105 105 105 105 105 105 101 101 101 101 101 101 101 101 101 101 101 101 101 101 101 101 101 101 101 101 101 101 101 104 104 107 104 104 104 104 104 104 104 104 104 104 104 104 104 104 104 104 104 104
104 104 104 104 104 104 104 104 104 104 105 105 105 105 105 105 105 105 105 101 101 101 101 101 101 101 101 101 101 101 101 101 101 101 101 101 101 101 101 101 104 104 104 107 104 104 104 104 104 104 104 104 104 104 104 104 104 104 104 104 104 104
104 104 104 104 104 104 104 104 104 104 104 105 105 105 105 105 105 105 105 101 101 101 101 101 101 101 101 101 101 101 101 101 101 101 101 101 101 104 104 104 104 104 104 107 104 104 104 104 104 104 104 104 104 104 104 104 104 104 104 104 104 104
104 104 104 104 104 104 104 104 104 104 104 105 105 105 105 105 105 105 105 101 101 101 101 101 101 101 101 101 101 101 101 101 101 101 101 101 101 104 104 104 104 104 104 107 104 104 104 104 104 104 104 104 104 104 104 104 104 104 104 104 104 104
104 104 104 104 104 104 104 104 104 104 104 104 105 105 105 105 105 105 105 101 101 101 101 101 101 101 101 101 109 109 109 109 109 109 109 109 104 104 104 104 104 101 101 107 101 101 101 101 101 101 104 104 104 104 104 104 104 104 104 104 104 104
104 104 104 104 104 104 104 104 104 104 104 104 105 105 105 105 105 105 105 105 101 101 101 101 101 101 101 109 110 110 110 110 110 110 110 108 104 104 104 104 101 101 101 101 101 101 101 101 101 101 101 104 104 104 104 104 104 104 104 104 104 104
104 104 104 104 104 104 104 104 104 104 104 104 104 105 105 105 105 105 105 105 101 101 101 101 101 101 101 110 110 108 108 108 108 108 108 101 104 104 104 101 101 101 101 101 101 101 101 101 101 101 101 101 104 104 104 105 104 104 104 104 104 104
104 104 104 104 104 104 104 104 104 104 104 104 104 104 105 105 105 105 105 105 105 101 101 101 101 101 101 110 110 101 101 101 101 101 101 101 104 104 104 101 101 101 101 101 101 101 101 101 101 101 101 101 104 104 105 105 105 104 104 104 104 104
104 104 104 104 104 104 104 104 104 104 104 104 104 104 104 105 105 105 105 105 105 101 101 101 101 101 101 110 110 101 101 101 101 101 106 106 106 106 106 106 101 101 101 101 101 101 101 101 101 101 101 106 106 106 106 105 105 105 104 104 104 104
104 104 104 104 104 104 104 104 104 104 104 104 104 104 104 104 104 105 105 105 105 105 105 101 101 101 101 110 108 101 101 101 101 101 101 104 104 104 104 101 101 101 101 101 101 101 101 101 101 101 101 101 104 104 105 105 105 104 104 104 104 104
104 104 104 104 104 104 104 104 104 104 104 104 104 104 104 104 104 104 105 105 105 105 105 105 101 101 101 108 101 101 101 101 101 101 101 104 104 104 104 101 101 101 101 101 101 101 101 101 101 101 101 101 104 104 104 105 104 104 104 104 104 104
104 104 104 104 104 104 104 104 104 104 104 104 104 104 104 104 104 104 104 104 104 104 104 104 104 104 104 104 104 104 104 104 104 104 104 104 104 104 104 104 105 105 105 101 101 101 105 105 105 105 105 104 104 104 104 104 104 104 104 104 104 104
104 104 104 104 104 104 104 104 104 104 104 104 104 104 104 104 104 104 104 104 104 104 104 104 104 104 104 104 104 104 104 104 104 104 104 104 104 104 104 104 104 105 105 105 105 105 105 105 105 105 104 104 104 104 104 104 104 104 104 104 104 104
104 104 104 104 104 104 104 104 104 104 104 104 104 104 104 104 104 104 104 104 104 104 104 104 104 104 104 104 104 104 104 104 104 104 104 104 104 104 104 104 104 104 104 104 104 104 104 104 104 104 104 104 104 104 104 104 104 104 104 104 104 104
104 104 104 104 104 104 104 104 104 104 104 104 104 104 104 104 104 104 104 104 104 104 104 104 104 104 104 104 104 104 104 104 104 104 104 104 104 104 104 104 104 104 104 104 104 104 104 104 104 104 104 104 104 104 104 104 104 104 104 104 104 104
104 104 104 104 104 104 104 104 104 104 104 104 104 104 104 104 104 104 104 104 104 104 104 104 104 104 104 104 104 104 104 104 104 104 104 104 104 104 104 104 104 104 104 104 104 104 104 104 104 104 104 104 104 104 104 104 104 104 104 104 104 104
104 104 104 104 104 104 104 104 104 104 104 104 104 104 104 104 104 104 104 104 104 104 104 104 104 104 104 104 104 104 104 104 104 104 104 104 104 104 104 104 104 104 104 104 104 104 104 104 104 104 104 104 104 104 104 104 104 104 104 104 104 104
104 104 104 104 104 104 104 104 104 104 104 104 104 104 104 104 104 104 104 104 104 104 104 104 104 104 104 104 104 104 104 104 104 104 104 104 104 104 104 104 104 104 104 104 104 104 104 104 104 104 104 104 104 104 104 104 104 104 104 104 104 104
104 104 104 104 104 104 104 104 104 104 104 104 104 104 104 104 104 104 104 104 104 104 104 104 104 104 104 104 104 104 104 104 104 104 104 104 104 104 104 104 104 104 104 104 104 104 104 104 104 104 104 104 104 104 104 104 104 104 104 104 104 104
104 104 104 104 104 104 104 104 104 104 104 104 104 104 104 104 104 104 104 104 104 104 104 104 104 104 104 104 104 104 104 104 104 104 104 104 104 104 104 104 104 104 104 104 104 104 104 104 104 104 104 104 104 104 104 104 104 104 104 104 104 104
104 104 104 104 104 104 104 104 104 104 104 104 104 104 104 104 104 104 104 104 104 104 104 104 104 104 104 104 104 104 104 104 104 104 104 104 104 104 104 104 104 104 104 104 104 104 104 104 104 104 104 104 104 104 104 104 104 104 104 104 104 104
104 104 104 104 104 104 104 104 104 104 104 104 104 104 104 104 104 104 104 104 104 104 104 104 104 104 104 104 104 104 104 104 104 104 104 104 104 104 104 104 104 104 104 104 104 104 104 104 104 104 104 104 104 104 104 104 104 104 104 104 104 104
104 104 104 104 104 104 104 104 104 104 104 104 104 104 104 104 104 104 104 104 104 104 104 104 104 104 104 104 104 104 104 104 104 104 104 104 104 104 104 104 104 104 104 104 104 104 104 104 104 104 104 104 104 104 104 104 104 104 104 104 104 104